R 1280 720
NO ./textures/sand.xpm
SO ./textures/dirt.xpm
WE ./textures/bricks.xpm
EA ./textures/cobblestone.xpm

F 155,118,83
C 135,206,235


 1111111 1111  111111111
 1000001110011110001000111
 1010101100001100000000001
 1011101100001100000000001
 100000000000000000N000001
 1000001100001100000000001
 1000001100001100000000001
 1000001110011111111101111
 1010101110011111111000111
 1110111100001100110000001
 1110111110011100110000001
 1000001100000000110000001
 1000001110011000111000111
 10000011000011001111011
 10000011100110000111011
 10000111111111111110001
 1000010000011000111000111
 1000010100111000010101001
 1000000000000000000000001
 1000010100111000010101001            1111111
 1000010000011000101000111           110000011
 10000100000110000010001            11000000011
 11111111111111001111111           1100000000011
              1001                110001111100011
              10011111111111111111100011   110001
              1000000000000000000000001     10001
              1000000000000000000000001     10001
              11111111111111111111100011   110001
                                  110001111100011
                                   1100000000011
                                    11000000011
                                     110000011
                                      1111111